22 serialization::archive 19 0 0 0 0 10 64 0 0 0 0 0 4 3 4 5 Sheep 1 0
0 0 0 0 0 0 0 4 3 0 0 0 -4 8 4 0 0 4
1 -3 4 0 8 34 4 -1 -1 0 0 1 0 4 0 4
2 -7 1 0 8 34 4 4
3 7 0 0 8 34 4 -1 -1 1 0 4 2 4 1 1 0 4
4 3 3 0 -4 21 4 4 2 4 3 0 0 0 0 3 3 4 4 5 3 11 3 Fox 1 0
5 5 3 0 12 25 12 11
6 0 -1 0 12 28 12 11
7 6 0 0 12 31 12 -1 -1 1 0 11 6 11
8 -1 5 0 12 29 12 -1 -1 1 0 11
9 6 -3 0 12 26 12 11 8 11 6 0 0 1 0 11 5 11 7 0 0 -1 5 11 8 7 0 4 3 6 -3 11 9 0 -1 11 6 -7 1 4 2 -3 4 4 1 6 0 11 7
