22 serialization::archive 19 0 0 0 0 46 64 0 0 0 0 0 8 13 4 6 Animal 1 0
0 0 0 0 0 8 13 0 0 0 3 542 1 0 0 4
1 4 11 0 3 554 1 4
2 9 8 0 3 564 1 4
3 2 9 0 3 562 1 4
4 -7 14 0 3 561 1 4
5 -4 6 0 3 569 1 4
6 13 -7 0 3 565 1 -1 -1 0 0 1 0 4 5 4
7 19 24 0 1 561 3 4
8 21 19 0 1 572 3 -1 -1 2 0 4 7 4
9 -8 29 0 1 553 3 4 8 4 6 0 0 4 6 1 0 4
10 4 0 0 1 566 3 4 7 4 8 0 0 4 0 4
11 0 0 0 3 554 1 4 5 4 6 1 0 4
12 6 -5 0 3 542 1 4 11 4 6 0 0 4 4 4
13 -1 9 0 3 568 1 4 5 4
14 -16 7 0 3 558 1 4
15 -6 13 0 3 566 1 4 4 4 10 4 0 4 14 4
16 -6 8 0 3 561 1 4 15 4 14 2 0 4
17 -11 7 0 3 562 1 4 16 4
18 7 20 0 3 565 1 4 15 4 16 1 0 4
19 -5 13 0 3 558 1 4 18 4 17 0 0 1 0 4
20 6 14 0 3 561 1 4 17 4 19 1 0 4
21 2 12 0 3 558 1 4 20 4
22 12 13 0 3 557 1 4
23 2 15 0 3 557 1 4
24 0 11 0 3 557 1 4 4 4
25 0 10 0 3 563 1 4 13 4
26 0 14 0 3 555 1 4 14 4 13 2 0 4
27 3 11 0 3 551 1 4 26 4
28 -10 6 0 3 554 1 4
29 -4 10 0 3 563 1 4 25 4 26 1 0 4 28 4 26 1 0 4
30 -9 0 0 3 554 1 4 28 4 27 1 0 4
31 -2 7 0 3 556 1 4 30 4 27 1 0 4
32 -3 3 0 3 550 1 4 31 4
33 5 9 0 3 564 1 4 5 4 31 0 0 0 0 1 0 4
34 3 13 0 3 531 1 4 27 4 25 0 0 4
35 -1 17 0 3 551 1 4 26 4
36 -1 11 0 3 566 1 4 13 4 26 0 0 0 0 3 0 4 29 4
37 1 22 0 3 562 1 4 25 4 20 0 0 4
38 2 13 0 3 546 1 4 25 4 34 0 0 2 0 4 23 4
39 2 12 0 3 549 1 4 24 4 34 0 0 4 2 1 0 4 22 4 2 1 0 4
40 5 13 0 3 540 1 4 22 4 0 0 0 1 0 4
41 5 12 0 3 551 1 4 21 4 22 1 0 4
42 6 13 0 3 545 1 4 41 4 40 0 0 4
43 -3 9 0 3 555 1 4 16 4 29 1 0 4
44 -1 7 0 3 550 1 4 43 4 31 0 0 4 18 4
45 -6 13 0 3 566 1 4 15 4 4 0 0 4 10 1 0 4 26 2 0 4 25 4 36 4 33 4 10 3 0 4 15 4 3 4 24 4 10 1 0 4 2 4 10 1 0 4 1 4 22 1 0 4 0 4 22 0 0 6 13 4 42 19 24 4 7 0 11 4 24 2 12 4 39 2 12 4 21 -1 7 4 44 6 -5 4 12 5 9 4 33 -7 14 4 4 0 0 4 11 3 13 4 34 -4 10 4 29 -8 29 4 9 -3 9 4 43 13 -7 4 6 3 11 4 27 2 15 4 23 5 13 4 40 -10 6 4 28 -1 17 4 35 5 12 4 41 -9 0 4 30 6 14 4 20 -11 7 4 17 21 19 4 8 7 20 4 18 -16 7 4 14 -3 3 4 32 12 13 4 22 -5 13 4 19 0 14 4 26 -4 6 4 5 4 11 4 1 1 22 4 37 -1 9 4 13 -6 8 4 16 -6 13 4 15 -6 13 4 45 -1 11 4 36 -2 7 4 31 9 8 4 2 2 9 4 3 4 0 4 10 2 13 4 38 0 10 4 25
