22 serialization::archive 19 0 0 0 0 10 64 0 0 0 0 0 1 1 4 5 Sheep 1 0
0 0 0 0 0 0 0 1 1 0 0 0 8 0 4 0 0 -1 -1 0 0 1 0 4
1 1 1 0 8 0 4 4 0 4
2 1 1 0 8 0 4 -1 -1 1 0 4
3 1 1 0 8 0 4 4 2 4 1 0 0 1 0 4
4 1 1 0 8 0 4 4 1 4 0 0 0 1 1 4 2 1 1 4 1 1 1 4 3 1 1 4 4 3 3 11 3 Fox 1 0
5 3 3 0 12 0 12 -1 -1 1 0 11
6 3 3 0 12 0 12 11 5 11
7 3 3 0 12 0 12 -1 -1 1 0 11
8 3 3 0 12 0 12 11 7 11 6 0 0 1 0 11
9 3 3 0 12 0 12 11 6 11 5 0 0 3 3 11 7 3 3 11 6 3 3 11 8 3 3 11 9
